NO assets/cyberpunk1.xpm
SO assets/cyberpunk2.xpm
WE assets/cyberpunk3.xpm
EA assets/cyberpunk4.xpm

F 30,30,30
C 20,20,20

1111111111
1000000001
1000000001
D000N00001
1000000001
1000000001
1111111111
