NO assets/cyberpunk1.xpm
SO assets/cyberpunk2.xpm
WE assets/cyberpunk3.xpm
EA assets/cyberpunk4.xpm

F 30,30,30
C 20,20,20

11111111111111111111
10000000000000000001
10N00000000000000001
10000000000000000001
10000000000000000001
10000000000000000001
10000000000000000001
10000000000000000001
10000000000000000001
10000000000000000001
10000000000000000001
10000000000000000001
10000000000000000001
10000000000000000001
10000000000000000001
10000000000000000001
10000000000000000001
10000000000000000001
10000000000000000001
11111111111111111111
