NO ./path_to_the_north_texture
SO ./path_to_the_south_texture
WE ./path_to_the_west_texture
EA ./path_to_the_east_texture

F 255,0,0
C 0,0,255

1111111111111111111111111111111111111
1000000000000000000000000000000000001
1000000000000111111101111111111111111
1000000000111111110001111000111111111
100000001111111E000001000000111111111
1000011111111000000000000000111111101
1001111111000000000000000111111110001
1011111100000000000000011111110000001
1011110000000000000001111111000000001
1011111111111111111101111111000001111
1011111111111111111101111111000111111
1000000000000111111101111111011111111
1000000000000111111100000000000000001
1000000000000111111100000000000000001
1111111111111111111111111111111111111
