NO assets/tile.xpm
SO assets/metal_wire.xpm
WE assets/fire.xpm
EA assets/brick.xpm

F 220,100,0
C 225,30,0

        111111111111111111111111
        1000000000110000000000001
        1011000001110000000000001
        1001000000D00000000000001
11111111101100000111000000N00000
100000000011000001110111111111111
11110111111111011100000010001
11110111111111011101010010001
11000000110101011100000010001
10000000000000001100000010001
10000000000000001101010010001
100000111010101111101111000111
11110111 1110101 101111010001
11111111 1111111 111111111111
