NO assets/tile.xpm
SO assets/metal_wire.xpm
WE assets/fire.xpm
EA assets/brick.xpm
F 220,100,0
C 225,30,0
111111111111
100000000001
100000000001
1000N0000001
111111111111
