NO ./textures/wall_north.xpm
SO ./textures/wall_south.xpm
WE ./textures/wall_west.xpm
EA ./textures/wall_east.xpm
B 220,100,0
W 225,30,0

111111111111
100000000001
100000000001
1000N0000001
111111111111
