NO assets/tile.xpm
SO assets/tile.xpm
WE assets/tile.xpm
EA assets/tile.xpm

F 220,100,0
C 225,30,0

        1111111111111111111111111
        1000000000110000000000001
        1011000001110000000000001
        1001000000000000000000001
111111111011000001110000000000001
100000000011011101110111111111111
11110111111111 11100000010001
11110111111111 11101010010001
11000000110101111100000000001
10000000000000001100000000000
10000000000000001101010010001
11000001110101011111011110N01 1111
11110111 1110101 101111010001 1001
11111111 1111111 111111111111 1111
