NO assets/brick.xpm
SO assets/tile.xpm
WE assets/metal_wire.xpm
EA assets/fire.xpm

F 220,100,0
C 225,30,0

111111111111111111111111111111111111111111
111111111111111111111111111111111111111111
111110001111111111111111111111111111111111
111110001111111111111111111111111111111111
111111101111111111111111111111111111111111
111000001000111110101000000000000000011111
111000001000111110101000000000000000011111
111000000000111110101000000000000000011111
111000001000111110101111111111111111011111
111000001000100010000000000000000000000001
111000001000100010000000000000000000010001
111111111101100010011111111111111110011111
111110000000100010011111111111111110010001
111110000000110110011111111111111110000001
111110000000000000010010010010010010011111
111000000000000000010010010010010010000001
111000000000000000010010010010010010010001
11100000W000000000011010110110111010011111
110000000000000000000000000000000000010001
110000000000000000000000000000000000000001
111000000000000000010111010111010111011111
11100000000000000001001001001001001001
11100000000000000001001001001001001001
11111000000000000001001001001001001001
11111110011111111001111111111111111111
11100000010010001001
11100000010010001001
11100000010010000001
11100000000010001001
11100000011110001001
11100000011110001001
11100000011110001001
11100000011110001001
11100000011110001001
11111111111111111111