NO assets/cyberpunk1.xpm
SO assets/cyberpunk1.xpm
WE assets/cyberpunk1.xpm
EA assets/cyberpunk1.xpm

F 30,30,30
C 0,30,0

1111
1001
100N0D1
1111