NO assets/tile.xpm
SO assets/metal_wire.xpm
WE assets/fire.xpm
EA assets/brick.xpm

F 220,100,0
C 0,30,0

11111
10001
10N01
10001
11111
