NO assets/cyberpunk1d.xpm
SO assets/cyberpunk1d.xpm
WE assets/cyberpunk1d.xpm
EA assets/cyberpunk1d.xpm
F 80,20,20
C 20,20,80

111111
E00001
100001
111111
