NO assets/Tiled.xpm
SO assets/Tiled.xpm  
WE assets/Tiled.xpm
EA assets/Tiled.xpm
F 80,20,20
C 20,20,80

111111
100001
100E01
111111
