NO ./textures/wall_north.xpm
SO ./textures/wall_south.xpm
WE ./textures/wall_west.xpm
EA ./textures/wall_east.xpm
C 225,30,0
F 220,100,0

111111111111
100000000001
100000000001
1000000N0001
111111111111
