NO ./assets/tiled.xpm
SO ./assets/tiled.xpm
WE ./assets/tiled.xpm
EA ./assets/tiled.xpm
F 80,20,20
C 20,20,80

11111111
10000001
100N0001
10000001
1111 111
