NO ./assets/cyberpunk1.xpm



SO ./assets/cyberpunk1.xpm



WE ./assets/cyberpunk1.xpm


EA ./assets/cyberpunk1.xpm

F 300,,,,,,,100,0
C 22,5,30,0,57

111111
100101
101001
1000S1
111111