NO assets/Tiled.xpm
SO assets/Tiled.xpm
WE assets/Tiled.xpm
EA assets/Tiled.xpm
F 80,20,20
C 20,20,80

11111111
1000N001
1000 001
11111111
