NO ./assets/cyberpunk1.xpm



SO ./assets/cyberpunk2.xpm



WE ./assets/cyberpunk3.xpm


EA ./assets/cyberpunk4.xpm

F -300,100,0
C 225,-30,0

111111
100101
101001
1000S1
111111