NO ./assets/cyberpunk1.xpm
SO ./assets/cyberpunk1.xpm
WE ./assets/cyberpunk1.xpm
EA ./assets/cyberpunk1.xpm

F 30,30,30
C 20,20,20

        1111111111111111111111111