N ./textures/diamond.png



S ./textures/diamond.png



W ./textures/diamond.png


E ./textures/diamond.png

F 30,30,30
C 20,20,20

111111
100101
101001
100001
111111