NO ./assets/does_not_exist.xpm



SO ./assets/cyberpunk4.xpm



WE ./assets/cyberpunk4.xpm


EA ./assets/cyberpunk4.xpm

F 30,30,30
C 20,20,20

111111
100101
101001
1000S1
111111