NO assets/tile.xpm
SO assets/tile.xpm
WE assets/tile.xpm
EA assets/tile.xpm
F 80,20,20
C 20,20,80

11111111
1000000
1000N01
11111 1
