NO assets/Tiled.xpm
SO assets/Tiled.xpm
WE assets/Tiled.xpm
EA assets/Tiled.xpm
F 80,20,20
C 20,20,80

11111111
10000001
100N0001
100 0001
 0000001
11111111
