NO assets/cyberpunk1.xpm
SO assets/cyberpunk2.xpm
WE assets/cyberpunk3.xpm
EA assets/cyberpunk4.xpm
F 80,20,20
C 20,20,80

111111
100001
10E000
111111
