NO assets/cyberpunk1.xpm
SO assets/cybersomeyt.xpm
WE assets/cyberpunk3.xpm
EA assets/cyberpunk4.xpm

F 30,30,30
C 20,20,20

        1111111111111111111111111
        1000000000110000000000001
        1011000001110000000000001
        1001000000000000000000001
111111111011000001110000000000001
100000000011011101110111111111111
11110111111111 11100000010001
11110111111111 11101D10010001
11000000110101111100000000001
10000000000000001100E00000001
10000000000000001101010010001
11000001110101011111011110001 1
11110111 1110101 101111010001
11111111 1111111 111111111111
