NO assets/cyberpunk1.xpm
SO assets/cyberpunk2.xpm
WE assets/cyberpunk3.xpm
EA assets/cyberpunk4.xpm

F 30,30,30
C 20,20,20

        111111111111111111111111
        1000000000110000000000001
        1D11000001110000000000001
        100D000000D00000000000001
11111111101100000111000000N000001
10000000001100000111D11D11D111111
11110111111111011100000010001
11110111111111011101010010001
11000000110101011100000010001
10000000000000000D00000010001
100000000000000001010100D0001
100000111010101111101111000111
11110111 1110101 101111010001
11111111 1111111 111111111111
