NO textures/cobbeele.xpm
SO textures/stoeene.xpm
WE textures/deeeepslate.xpm
EA textures/stoeenebrick.xpm

F 25,97,30
C 83,142,224

1111111111111111111
1000000010000000001
1000EK0010000000001
1000010010000000001
10000000D0000000001
1000000010000000001
1111111111111111111