NO textures/red_brick.xpm
SO textures/gray_stone.xpm
WE textures/mossy.xpm
EA textures/mossy.xpm

F 100,150,0
C 100,100,255

1111111111111111111
1000000010000000001
10000K0010000000001
10E0010010000000001
10000000D0000000001
1000000010000000001
1111111111111111111